44444444444444*****
*                 *
*  ****************
*                 *
****************  *
*                 *
* *****************
*                 *
********************